Nazwa_kategorii,Ilość_bezpośrednich_artykułów,Ilość_bezpośrednich_subkategorii,Ilość_subkategorii ,Ilość_artykułów,Liczba_wersji_językowych,Liczba_wyświetleń_strony_kategorii_w_2019,Liczba_wyświetleń_artykułów_11.08.2019,Suma_punktów,Ocena_jakości
Povijest_Europe,5,42,1623,23180,134,384,1,25369,Good
Povijest_Europe,5,42,1623,23180,134,384,1,25369,Good
Književnost,83,26,443,10985,208,1109,3,12857,Good
Društvene_znanosti,42,21,12485,148880,160,639,1,162228,Good
Religija,68,19,883,9833,240,924,2,11969,Good
Primijenjene_znanosti,39,22,4342,62429,117,690,4,67643,Good
Kalendar,57,15,482,22631,161,602,38,23986,Good
Kultura,96,36,8187,86711,210,899,3,96142,Good
Biologija,93,32,8794,71966,220,962,1,82068,Good
Jezikoslovlje,107,24,1519,9092,178,638,6,11564,Good
Države_u_Europi,0,50,7462,84639,192,14579,3,106925,Good
Scenska_umjetnost,17,9,71,2822,78,355,1,3353,Good
Kršćanstvo,172,31,607,6916,209,586,2,8523,Good
Tehnologija,158,23,867,12462,165,806,1,14482,Good
Znanje,3,4,17939,181182,105,247,7,199487,Good
Umjetnost,54,22,4410,61900,206,3014,2,69608,Good
Politika_Hrvatske,57,11,863,20866,56,338,1,22192,Good
Glazba,138,36,1081,12079,217,942,1,14494,Good
Znanost,65,33,17936,181151,239,870,7,200301,Good
Geologija,73,22,10762,120982,165,455,3,132462,Good
Astronomija,162,23,265,10773,215,756,1,12195,Good
Matematika,142,19,56,861,227,1106,1,2412,Good
Fizika,92,23,1099,36231,201,764,7,38417,Good
Povijest_Rusije,147,10,53,905,113,338,1,1567,Good
Ekonomija,85,23,1344,18575,182,790,1,21000,Good
Filozofija,106,17,1076,34825,199,852,7,37082,Good
Geografija,47,14,11185,122347,244,931,1,134769,Good
Povijest_Grčke,48,8,72,807,102,197,8,1242,Good
Fizička_geografija,44,7,10742,120697,95,361,1,131947,Good
Kiparstvo,42,7,51,1091,108,295,3,1597,Good
Kemija,256,25,721,10165,210,3227,1,14605,Good
Antropogeografija,21,9,10947,120959,87,334,1,132358,Good
Sveta_Stolica,33,6,30,490,49,131,3,742,Good
Komunikacije,75,15,428,9849,138,653,1,11159,Good
Medicina,42,24,304,4101,172,1119,1,5763,Good
Indoeuropski_jezici,19,13,177,1638,145,192,1,2185,Good
Genealogija,15,3,5,190,83,248,1,545,Good
Povijest_filozofije,7,5,38,307,70,134,8,569,Good
Psihologija,218,10,119,1736,161,1141,8,3393,Good
Povijest_Austrije,34,5,22,534,90,215,4,904,Good
Povijest_Italije,72,16,179,2585,106,242,2,3202,Good
Povijest_Mađarske,84,6,23,560,85,176,4,938,Good
Arhitektura,70,12,1990,32199,169,555,2,34997,Good
Ujedinjeno_Kraljevstvo,48,25,410,4763,207,454,1,5908,Good
Pismo,61,8,11,214,119,398,1,812,Good
Slikarstvo,79,9,133,1987,126,559,1,2894,Good
Promet,34,15,575,5828,167,389,2,7010,Good
Astronautika,15,12,30,480,52,150,1,740,Good
Francuska_književnost,50,5,7,169,92,148,3,474,Good
Američka_književnost,83,5,6,191,84,215,5,589,Good
Talijanska_književnost,22,1,3,70,75,145,1,317,Good
Zoologija,73,10,4695,44880,142,295,3,50098,Good
Švedska_književnost,8,1,1,19,56,87,3,175,Good
Patologija,21,3,56,247,71,171,5,574,Good
Povijest_Francuske,103,19,59,617,126,341,2,1267,Good
Povijest_Njemačke,83,16,63,1062,119,278,5,1626,Good
Antropologija,74,6,6207,55439,148,494,3,62371,Good
Botanika,87,10,641,4667,159,465,1,6030,Good
Jezici,12,19,1440,7827,265,522,6,10091,Good
SSSR_u_Drugom_svjetskom_ratu,35,3,3,44,40,369,1,495,Good
Biokemija,24,6,574,7619,112,393,1,8729,Good
Domaće_životinje,26,3,5,83,110,410,11,648,Good
Elektrotehnika,114,7,31,497,81,689,1,1420,Good
Arheologija,36,13,122,1848,146,333,10,2508,Good
Španjolska_književnost,10,2,2,29,70,255,1,369,Good
Povijest_Azije,6,31,213,3106,115,153,1,3625,Good
Kartografija,48,5,543,7137,100,358,1,8192,Good
Hidrologija,45,2,4,68,105,261,1,486,Good
Zemljopisni_popisi,21,5,59,962,72,236,1,1356,Good
Demografija_Hrvatske,5,3,106,2406,24,269,1,2814,Good
Belgijska_književnost,6,1,1,20,38,84,2,152,Good
Građevinarstvo,80,4,760,7164,64,431,1,8504,Good
Sociologija,188,10,39,604,149,735,8,1733,Good
Javna_uprava,11,6,1032,23518,64,267,1,24899,Good
Međunarodni_odnosi,20,8,61,1249,103,244,3,1688,Good
Australija,32,11,72,695,187,299,1,1297,Good
Pravo,179,23,66,3204,166,822,3,4463,Good
Elektronika,81,3,3,23,115,550,5,780,Good
Meksiko,36,11,90,822,179,180,1,1319,Good
Novi_Zeland,35,7,30,164,158,203,1,598,Good
Povijest_Afrike,25,12,51,729,106,178,1,1102,Good
Optika,90,6,11,177,122,391,1,798,Good
Indijski_ocean,20,5,35,363,108,168,1,700,Good
Fiziologija,20,8,19,223,119,379,2,770,Good
Odgoj_i_obrazovanje_u_Hrvatskoj,145,10,20,385,31,225,1,817,Good
Grčki_jezik,15,2,26,438,91,134,5,711,Good
Farmacija,27,5,19,417,67,224,1,760,Good
Fotografija,48,1,6,148,126,410,1,740,Good
Islam,153,13,45,514,190,895,1,1811,Good
Pseudoznanost,38,5,9,176,75,319,2,624,Good
Političke_ideologije,89,9,117,1901,92,594,5,2807,Good
Valute,32,7,11,283,126,284,1,744,Good
Slavenski_jezici,13,3,32,627,139,167,1,982,Good
Povijest_znanosti,11,4,53,633,87,166,3,957,Good
Oružane_snage_SAD-a,54,4,33,261,66,270,3,691,Good
Stočarstvo,19,3,6,38,80,163,1,310,Good
Pjesništvo,48,3,19,1453,131,362,1,2017,Good
Budizam,49,3,7,69,147,348,2,625,Good
Folklor,17,2,3,74,104,215,1,416,Good
Kolonijalizam,38,2,2,19,94,214,1,370,Good
Mikrobiologija,19,5,50,166,102,262,5,609,Good
Statistika,33,3,3,29,104,430,1,603,Good
Tihi_ocean,63,4,21,275,117,202,4,686,Good
Ratna_mornarica,20,6,35,493,69,174,2,799,Good
Stoljeća,144,73,353,21524,147,435,38,22714,Good
Djetinjstvo,18,2,6,44,77,236,2,385,Good
Farmakologija,24,1,1,6,84,173,1,290,Good
Komunizam,88,4,37,754,114,349,1,1347,Good
Književna_povijest,27,4,40,616,69,212,5,973,Good
Povijest_Poljske,68,7,8,90,93,219,2,487,Good
Etika,65,2,8,103,108,447,10,743,Good
Logika,68,1,1,11,108,418,11,618,Good
Knjižničarstvo,108,5,25,524,75,377,1,1115,Good
Strojarstvo,165,11,45,819,70,606,1,1717,Good
Međunarodno_pravo,41,3,5,158,95,235,1,538,Good
Otorinolaringologija,12,2,2,24,56,102,1,199,Good
Judaizam,85,6,10,133,131,513,3,881,Good
Preusmjeravanja_povezana_sa_stavkom_na_projektu_Wikipodatci,150,8,32,694,52,143,1,1080,Good
Grafički_dizajneri,9,1,1,18,32,87,1,149,Good
Prehrambena_industrija,17,2,5,42,70,164,5,305,Good
Industrija,20,14,157,2817,118,365,1,3492,Good
Topništvo,40,2,3,52,61,266,2,426,Good
Oceanografija,22,2,2,36,93,157,2,314,Good
Vojna_teorija,50,2,2,20,67,342,1,484,Good
Hidrotehnika,21,6,25,334,49,146,5,586,Good
Šumarstvo,52,3,7,99,76,295,3,535,Good
Izabrani_članci,724,2,2,0,150,1432,0,2310,Good
Povijest_Španjolske,112,7,18,218,104,307,1,767,Good
Germanski_jezici,7,3,21,101,138,192,1,463,Good
Baskijski_jezik,6,3,3,20,44,103,0,179,Good
Oftalmologija,74,3,4,111,69,229,10,500,Good
Povijest_Portugala,24,1,1,18,87,127,3,261,Good
Arhivistika,9,3,17,422,41,140,1,633,Good
Čehoslovačka,34,2,4,30,85,146,1,302,Good
Baltički_jezici,12,1,1,2,88,92,4,200,Good
Duhovnost,20,5,10,131,73,245,1,485,Good
Skulpture,42,4,4,41,66,187,3,347,Good
Kirurgija,39,3,3,25,80,330,1,481,Good
Filologija,7,3,24,177,97,145,2,455,Good
Dizajn,24,4,6,73,84,285,1,477,Good
Povijest_Švicarske,15,1,2,39,75,108,6,246,Good
Rudarstvo,25,3,6,292,70,200,11,607,Good
Dermatologija,13,1,1,11,78,157,3,264,Good
Portugalska_književnost,1,1,1,5,51,79,1,139,Good
Arhitektonski_elementi,88,2,2,27,75,659,3,856,Good
Konstrukcije,33,1,1,17,100,384,5,541,Good
Popisi_po_državama,14,8,50,896,55,187,1,1211,Good
Metali,9,2,5,270,111,245,11,653,Good
Povijest_Nizozemske,35,2,4,65,92,168,10,376,Good
Ilustratori,20,1,1,26,52,117,1,218,Good
Metalurgija,95,1,3,163,85,339,2,688,Good
Hidraulika,27,1,26,350,52,226,5,687,Good
Poljoprivreda,101,6,22,323,170,597,5,1224,Good
Anarhizam,20,1,1,14,87,144,2,269,Good
Republike_SSSR-a,26,1,1,5,59,170,0,262,Good
Pedijatrija,2,2,2,23,63,162,2,256,Good
Financije,67,2,4,46,104,523,1,747,Good
Agronomija,9,1,2,12,74,215,1,314,Good
Informacijske_znanosti,51,1,1,24,71,245,1,394,Good
Jezici_Crne_Gore,4,0,0,4,56,125,69,258,Good
Jezici_Italije,35,0,0,35,83,245,1,399,Good
Jezici_Srbije,17,0,0,17,67,208,1,310,Good
Jezici_Albanije,8,0,0,8,69,143,8,236,Good
Jezici_Rumunjske,14,0,0,14,64,125,1,218,Good
Jezici_Sjeverne_Makedonije,10,0,0,10,59,31,1,111,Good
Jezici_Turske,34,0,0,34,78,147,3,296,Good
Epistemologija,44,0,0,44,93,230,8,419,Good
Popisi_država,14,0,0,14,75,411,12,526,Good
Estetika,9,0,0,9,88,221,2,329,Good
Monoteističke_religije,9,0,0,9,28,453,33,532,Good
Desetljeća,213,0,0,213,98,344,1,869,Good
Stranice_s_pogrješkama_u_izvorima,225,0,0,225,86,991,1,1528,Good
Američki_izumitelji,29,0,0,29,81,311,2,452,Good
Američki_predsjednici,45,0,0,45,149,1009,3,1251,Good
Jezici_Francuske,29,0,0,29,88,211,1,358,Good
Američki_potpredsjednici,21,0,0,21,77,155,3,277,Good
Jezici_Bugarske,11,0,0,11,63,78,1,164,Good
Jezici_Grčke,14,0,0,14,71,101,1,201,Good
Slikarske_tehnike,37,0,0,37,56,313,5,448,Good
Stranice_s_čarobnim_RFC_poveznicama,22,0,0,22,47,544,2,637,Good
Navigacija,22,0,0,22,85,245,1,375,Good
Američki_arhitekti,17,0,0,17,72,205,1,312,Good
Numizmatika,25,0,0,25,71,179,1,301,Good
Vremenske_jedinice,13,0,0,13,110,359,2,497,Good
Jezici_Ukrajine,11,0,0,11,63,111,1,197,Good
Grčki_alfabet,28,0,0,28,75,277,2,410,Good
Logistika,10,0,0,10,62,193,1,276,Good
Rimsko_pravo,34,0,0,34,51,214,1,334,Good
Jezici_Cipra,3,0,0,3,58,87,5,156,Good
Stomatologija,24,0,0,24,80,208,4,340,Good
Kanonsko_pravo,19,0,0,19,45,115,3,201,Good
Albanski_jezici,9,0,0,9,57,109,8,192,Good
Kopnena_vojska,10,0,0,10,54,274,4,352,Good
Jezici_Gruzije,17,0,0,17,68,129,3,234,Good
Tajna_društva,14,0,0,14,56,201,3,288,Good
Heraldika,8,0,0,8,84,120,4,224,Good
Jezici_Armenije,6,0,0,6,54,83,1,150,Good
Povijest_Malte,11,0,0,11,53,79,2,156,Good
Životopisi,_Srebrenica,5,0,0,5,0,32,0,42,Bad
U_izradi,_Azerbajdžan,1,0,0,1,44,21,0,67,Bad
Otoci,_Sveti_Toma_i_Princip,2,0,0,2,23,64,0,91,Bad
Indijanci,_Manitoba,1,0,0,1,0,32,0,34,Bad
Meksički_Indijanci,_Yucatán,1,0,0,1,0,35,0,37,Bad
Astronomski_popisi,8,1,1,0,43,122,0,175,Bad
Nagrade_wikipedista,0,1,1,0,0,61,0,63,Bad
Suradnički_jezici,0,73,81,0,238,370,0,762,Bad
Wikipedija_Babilon,0,1,82,0,25,348,0,456,Bad
Suradnik_hr,0,4,4,0,238,224,0,470,Bad
Predlošci_sastava_športskih_klubova,0,1,1,0,19,54,0,75,Bad
Biološki_predlošci,0,3,3,0,88,97,0,191,Bad
Pomoćni_predlošci,0,5,6,0,0,65,0,76,Bad
Skupni_predlošci_administrativnih_podjela,0,15,36,0,48,97,0,196,Bad
Jezikoslovni_predlošci,0,3,5,0,42,76,0,126,Bad
Književni_predlošci,0,3,5,0,57,138,0,203,Bad
GFDL_slike,0,1,1,0,87,290,0,379,Bad
Snimke_ekrana,0,7,7,0,0,36,0,50,Bad
Slike_u_javnom_vlasništvu,0,13,13,0,55,113,0,194,Bad
Javno_dobro,0,3,16,0,0,66,0,85,Bad
Predlošci_sastava_nogometnih_reprezentacija,1,1,18,0,0,36,0,56,Bad
Popisi_mjesta,14,4,5,0,30,372,0,425,Bad
Skupni_atletski_predlošci,0,2,2,0,25,33,0,62,Bad
Skupni_olimpijski_predlošci,0,3,3,0,38,58,0,102,Bad
Športski_infookviri,0,11,12,0,59,83,0,165,Bad
Abecedni_popisi_osoba,0,28,28,0,11,150,0,217,Bad
Slike_UN,0,1,1,0,0,42,0,44,Bad
Slike_omota,0,5,5,0,0,29,0,39,Bad
Slike_naslovnih_stranica,0,4,4,0,0,39,0,47,Bad
Politika_Wikipedije,0,4,6,0,0,127,0,137,Bad
Skupni_košarkaški_predlošci,0,3,4,0,33,62,0,102,Bad
Slike_po_temama,0,4,27,0,32,86,0,149,Bad
Slike_hrvatskih_grbova_po_županijama,0,20,20,0,0,81,0,121,Bad
Slike_hrvatskih_grbova,0,3,23,0,0,110,0,136,Bad
Predlošci_za_stranice_u_izradi,0,4,4,0,89,200,0,297,Bad
Slike_logo,0,9,16,0,53,415,0,493,Bad
Slike_logo_-_sport,0,4,4,0,16,94,0,118,Bad
Infookviri,0,26,56,0,138,256,0,476,Bad
Potrebno_napraviti_predložak,0,1,1,0,0,66,0,68,Bad
Upute_za_odabir_predložaka,0,1,1,0,0,98,0,100,Bad
Povijesni_predlošci,0,3,3,0,77,109,0,192,Bad
Skupni_znanstveni_predlošci,0,14,54,0,31,56,0,155,Bad
Politički_predlošci,0,4,45,0,56,63,0,168,Bad
Farmakološki_predlošci,0,2,2,0,0,30,0,34,Bad
Prometni_predlošci,0,3,4,0,62,76,0,145,Bad
Automobilski_predlošci,0,2,2,0,23,69,0,96,Bad
Etnički_predlošci,0,3,3,0,0,35,0,41,Bad
Geološki_predlošci,0,2,2,0,0,28,0,32,Bad
Vojni_predlošci,1,2,2,0,49,74,0,128,Bad
Ekonomski_predlošci,0,2,2,0,54,82,0,140,Bad
Suradnički_predlošci,0,3,3,0,82,188,0,276,Bad
Jezični_predlošci,0,3,3,0,71,74,0,151,Bad
Filmski_predlošci,0,2,5,0,65,134,0,206,Bad
Predlošci_računalnih_igara,0,2,2,0,0,30,0,34,Bad
Kalendarski_predlošci,0,1,1,0,63,102,0,167,Bad
Predlošci_dobitnika_nagrada,0,1,1,0,0,39,0,41,Bad
Religijski_predlošci,0,2,2,0,74,59,0,137,Bad
Anatomski_predlošci,0,1,1,0,0,38,0,40,Bad
Fizikalni_predlošci,0,1,1,0,63,70,0,135,Bad
Astronomski_predlošci,0,2,2,0,70,100,0,174,Bad
Astrološki_predlošci,0,1,1,0,8,35,0,45,Bad
Košarkaški_predlošci,0,5,9,0,47,68,0,129,Bad
Mitološki_predlošci,0,1,1,0,0,25,0,27,Bad
Kemijski_predlošci,0,2,2,0,79,144,0,227,Bad
Gramatički_predlošci,0,2,2,0,0,29,0,33,Bad
Skupni_politički_predlošci,0,2,40,0,43,97,0,182,Bad
Olimpijski_predlošci,0,2,5,0,59,63,0,129,Bad
Predlošci_zastava,0,1,1,0,0,54,0,56,Bad
Predlošci_međunarodnih_organizacija,0,1,1,0,27,67,0,96,Bad
Skupni_zemljopisni_predlošci,0,4,40,0,59,119,0,222,Bad
Filozofski_predlošci,0,2,2,0,35,63,0,102,Bad
Predlošci_svjetske_baštine,0,1,1,0,0,31,0,33,Bad
Predlošci_o_Harryju_Potteru,0,2,2,0,21,50,0,75,Bad
Skupni_filmski_predlošci,0,2,2,0,25,74,0,103,Bad
Skupni_književni_predlošci,0,1,1,0,0,61,0,63,Bad
Predlošci_video_igara,0,2,2,0,0,27,0,31,Bad
Zemljopisni_infookviri,0,5,7,0,69,103,0,184,Bad
Atletski_predlošci,0,2,4,0,32,45,0,83,Bad
Rukometni_predlošci,0,2,3,0,35,35,0,75,Bad
Predlošci_za_Formulu_1,0,2,2,0,43,52,0,99,Bad
Predlošci_za_umjetnost,0,2,2,0,0,35,0,39,Bad
Televizijski_predlošci,0,2,3,0,43,70,0,118,Bad
Hrvatski_športski_predlošci,0,3,5,0,12,53,0,73,Bad
Skupni_rukometni_predlošci,0,1,1,0,24,47,0,73,Bad
Slike_novca,0,1,1,0,0,173,0,175,Bad
Slike_Creative_Commons,0,9,9,0,35,199,0,252,Bad
Predlošci_nogometnih_klubova,0,1,1,0,0,34,0,36,Bad
Skupni_predlošci_športskih_klubova,0,3,5,0,0,21,0,29,Bad
Predlošci_športskih_klubova,0,4,9,0,1,23,0,37,Bad
Predlošci_košarkaških_natjecanja,0,1,1,0,2,35,0,39,Bad
Predlošci_košarkaških_klubova,0,1,2,0,0,35,0,38,Bad
Predlošci_za_gradove,0,2,2,0,38,58,0,100,Bad
Slike_logo_-_mediji,0,2,2,0,1,82,0,87,Bad
Botovi,0,2,2,0,155,161,0,320,Bad
Wikipedija:Arhiv,0,3,3,0,0,115,0,121,Bad
Slike_s_nepotpunim_podacima,0,2,2,0,1,70,0,75,Bad
Zrakoplovni_predlošci,0,1,1,0,0,26,0,28,Bad
Skupni_predlošci_s_popisima_državnika,0,2,2,0,2,40,0,46,Bad
Popisi_naselja_u_Bosni_i_Hercegovini,1,1,1,0,0,64,0,67,Bad
Životopisi,_Srebrenica,5,0,0,5,0,32,0,42,Bad
U_izradi,_Azerbajdžan,1,0,0,1,44,21,0,67,Bad
Otoci,_Sveti_Toma_i_Princip,2,0,0,2,23,64,0,91,Bad
Indijanci,_Manitoba,1,0,0,1,0,32,0,34,Bad
Meksički_Indijanci,_Yucatán,1,0,0,1,0,35,0,37,Bad
Gradovi_u_Kanadi,_Nova_Škotska,1,0,0,1,23,51,2,78,Bad
Epizode_Zvjezdanih_staza,_Enterprise,1,0,0,1,0,21,0,23,Bad
Indijanska_sela,_Alsea,1,0,0,1,0,27,0,29,Bad
Kantoni_Kostarike,_San_Jose,4,0,0,4,0,26,0,34,Bad
Gradovi_u_Arizoni,_okrug_Greenlee,5,0,0,5,0,30,0,40,Bad
Gradovi_u_New_Yorku,_okrug_Albany,1,0,0,1,0,52,0,54,Bad
Jezici_Austrije,10,0,0,10,68,185,14,287,Bad
Jezici_Bosne_i_Hercegovine,6,0,0,6,50,283,24,369,Bad
Jezici_Crne_Gore,4,0,0,4,56,125,69,258,Bad
Jezici_Hrvatske,15,0,0,15,61,255,3,349,Bad
Jezici_Italije,35,0,0,35,83,245,1,399,Bad
Jezici_Mađarske,9,0,0,9,63,141,1,223,Bad
Jezici_SAD-a,106,0,0,106,80,320,1,613,Bad
Jezici_Slovačke,9,0,0,9,56,149,13,236,Bad
Jezici_Srbije,17,0,0,17,67,208,1,310,Bad
Jezici_po_abecedi:H,113,0,0,113,0,145,2,373,Bad
Stranice_s_čarobnim_ISBN_poveznicama,10775,0,0,10775,122,2225,1,23898,Bad
Državni_simboli_Hrvatske,6,0,0,6,34,574,23,643,Bad
Hrvatske_domoljubne_pjesme,17,0,0,17,2,2007,23,2066,Bad
Filozofija_povijesti,6,0,0,6,45,116,19,192,Bad
Članci_kojima_nedostaje_izvor,2692,0,0,2692,61,2254,1,7700,Bad
Bivše_europske_monarhije,17,0,0,17,43,428,2,507,Bad
Hrvatska_pravna_povijest,24,0,0,24,7,92,4,151,Bad
Hrvatski_povijesni_dokumenti,14,0,0,14,2,162,4,196,Bad
Izvori_za_hrvatsku_povijest,23,0,0,23,1,118,1,166,Bad
Seljačke_bune,5,0,0,5,27,93,1,131,Bad
Članci_u_koje_treba_uklopiti_drugi_tekst,128,0,0,128,0,299,2,557,Bad
Frankapani,23,0,0,23,8,105,1,160,Bad
Zrinski,25,0,0,25,9,109,1,169,Bad
Potrebna_stilska_dorada,733,0,0,733,45,805,3,2319,Bad
Arheološki_artefakti_u_Hrvatskoj,15,0,0,15,1,149,2,182,Bad
Trpimirovići,28,0,0,28,19,194,1,270,Bad
Premjestiti_u_Wikizvor,17,0,0,17,1,86,3,124,Bad
Hrvatski_baruni,38,0,0,38,4,198,2,280,Bad
Hrvatski_grofovi,32,0,0,32,4,304,1,373,Bad
Izdvojiti_u_novi_članak,51,0,0,51,0,202,4,308,Bad
Vitezovi_Zlatnoga_runa,152,0,0,152,36,326,2,668,Bad
Dalmatinski_namjesnici,9,0,0,9,0,59,39,116,Bad
Jelačići,6,0,0,6,0,72,2,86,Bad
Petrovaradin,23,0,0,23,4,74,2,126,Bad
Hrvatske_zemlje_pod_osmanskom_vlašću,32,0,0,32,7,188,1,260,Bad
Hrvatski_franjevci,209,0,0,209,5,358,1,782,Bad
Glazbeni_oblici,16,0,0,16,49,62,4,147,Bad
Logički_termini,11,0,0,11,0,172,11,205,Bad
Pohranjivanje_podataka,21,0,0,21,38,219,2,301,Bad
Poluvodičke_memorije,6,0,0,6,1,147,1,161,Bad
Izlazne_jedinice,8,0,0,8,39,172,2,229,Bad
MediaWiki_projekti,9,0,0,9,30,171,10,229,Bad
Dani_u_siječnju,32,0,0,32,16,215,2,297,Bad
Dani_u_rujnu,30,0,0,30,13,154,1,228,Bad
Pravopis,16,0,0,16,69,269,1,371,Bad
Hrvatski_isusovci,76,0,0,76,10,146,2,310,Bad
Mariolozi,8,0,0,8,0,54,2,72,Bad
Svjetska_književnost,34,0,0,34,2,140,2,212,Bad
Dobitnici_nagrade_Vladimir_Nazor,164,0,0,164,4,248,4,584,Bad
Hrvatski_enciklopedisti,13,0,0,13,2,153,5,186,Bad
Znanstvenici_kajkavskog_narječja,4,0,0,4,0,74,1,83,Bad
Dubrovačka_književnost,32,0,0,32,2,193,4,263,Bad
Hrvatski_pravnici,243,0,0,243,18,520,2,1026,Bad
Renesansni_pjesnici,16,0,0,16,2,193,3,230,Bad
Hrvatski_narodni_preporod,123,0,0,123,7,223,1,477,Bad
Matica_hrvatska,56,0,0,56,1,101,2,216,Bad
Dani_u_listopadu,31,0,0,31,12,129,4,207,Bad
Dani_u_studenom,30,0,0,30,14,311,2,387,Bad
Dani_u_prosincu,31,0,0,31,12,144,2,220,Bad
Dani_u_veljači,31,0,0,31,16,258,1,337,Bad
Erdődy,11,0,0,11,2,102,2,128,Bad
Bakterijske_bolesti,35,0,0,35,60,2200,10,2340,Bad
Pandemije,9,0,0,9,40,123,5,186,Bad
Pseudomonadaceae,1,0,0,1,0,60,3,65,Bad
Campylobacteraceae,1,0,0,1,4,38,2,46,Bad
Potrebno_wikipedizirati,689,0,0,689,0,435,2,1815,Bad
Clostridiaceae,2,0,0,2,0,35,0,39,Bad
Zvjezdana_astronomija,44,0,0,44,49,143,1,281,Bad
Dani_u_ožujku,32,0,0,32,16,188,4,272,Bad
Dani_u_travnju,30,0,0,30,15,176,2,253,Bad
Dani_u_svibnju,31,0,0,31,15,251,2,330,Bad
Kršćanski_molitvenici,12,0,0,12,12,65,3,104,Bad
Oslikani_rukopisi,17,0,0,17,28,97,3,162,Bad
Dani_u_lipnju,30,0,0,30,13,215,2,290,Bad
Dani_u_srpnju,31,0,0,31,13,208,4,287,Bad
Dani_u_kolovozu,31,0,0,31,13,185,8,268,Bad
Esperanto,26,0,0,26,86,100,1,239,Bad
Jezici_po_abecedi:E,89,0,0,89,0,115,11,304,Bad
Bunići,8,0,0,8,0,96,1,113,Bad
Kvantna_mehanika,47,0,0,47,81,309,2,486,Bad
Hrvatski_masoni,34,0,0,34,3,327,2,400,Bad
Hrvatski_pisci_iz_Bosne_i_Hercegovine,263,0,0,263,5,361,2,894,Bad
Zaštićene_stranice_za_neprijavljene_suradnike,43,0,0,43,45,430,6,567,Bad
Mjeseci_u_godini,12,0,0,12,180,47375,20,47599,Bad
Jezici_po_abecedi:B,644,0,0,644,0,136,2,1426,Bad
Godine_21._stoljeća,662,0,0,662,28,430,7,1789,Bad
Godine_20._stoljeća,2673,0,0,2673,26,606,1,5979,Bad
Godine_19._stoljeća,2074,0,0,2074,24,460,2,4634,Bad
Tehničke_znanosti,3,3,267,4342,0,97,3,4715,Bad
Države_u_Sjevernoj_i_Srednjoj_Americi,0,23,1010,20107,0,546,2,21688,Bad
Bolje_osmisliti_kategorizaciju,0,22,1632,20108,0,70,1,21833,Bad
Pretrpane_kategorije,0,22,11353,129673,0,195,7,141250,Bad
Povijest_Bosne_i_Hercegovine_1102.-1463.,57,2,7,100,0,267,4,437,Bad
Potreban_bolji_naslov_kategorije,0,30,794,10899,0,65,2,11790,Bad
Tiskani_mediji,19,8,64,772,0,294,2,1159,Bad
Tercijarne_djelatnosti,4,3,175,2221,0,2766,1,5170,Bad
Povijest_Crne_Gore_1989._-_2006.,16,2,4,49,0,71,24,166,Bad
Povijest_Srbije_1989._-_2006.,30,5,30,478,0,101,1,645,Bad
Hrvatski_filmski_umjetnici,14,8,8,825,0,468,1,1324,Bad
Sporni_članci,0,6,6,104,0,98,2,216,Bad
Vojna_povijest_20._stoljeća,6,3,174,2558,0,81,4,2826,Bad
Bosna_i_Hercegovina_pod_Austro-Ugarskom,22,5,21,464,0,171,9,692,Bad
Povijest_Slovenije_976.-1918.,5,3,18,455,0,62,9,552,Bad
Pisci,63,4,198,4935,0,549,3,5752,Bad
Nagrađeni_filmski_umjetnici,9,10,38,725,0,104,1,887,Bad
Liječništvo,9,2,25,644,0,110,1,791,Bad
Osobe_u_zdravstvu,9,2,21,588,0,105,1,726,Bad
Ruski_savezni_gradovi,2,2,4,108,0,105,1,222,Bad
Antičke_države,9,3,34,480,0,611,1,1138,Bad
Europska_športska_natjecanja,39,3,45,780,0,50,1,918,Bad
Archaeplastida,1,2,619,4458,0,38,2,5120,Bad
Opisthokonta,4,3,4712,44890,0,48,3,49660,Bad
Filmski_umjetnici_po_državama,0,12,51,2485,0,198,1,2747,Bad
Športovi_na_vodi,11,4,27,214,0,61,3,320,Bad
Međimurje,16,3,19,328,0,106,2,474,Bad
Prokarioti,3,1,41,55,0,43,7,150,Bad
Športovi_na_ledu,11,8,91,766,0,53,1,930,Bad
Američki_filmski_umjetnici,46,4,7,1177,0,175,1,1410,Bad
Francuski_filmski_umjetnici,1,2,3,54,0,53,4,117,Bad
Zimski_športovi,8,8,143,1151,0,42,1,1353,Bad
Njemačko_oružje_u_Drugom_svjetskom_ratu,15,2,2,33,0,1203,3,1258,Bad
Švedski_športski_klubovi,0,2,3,20,0,36,0,61,Bad
Čeljustouste,2,1,177,619,0,58,3,860,Bad
Panamerička_prvenstva,5,1,2,10,0,46,0,64,Bad
Britanski_filmski_umjetnici,12,2,2,186,0,79,3,284,Bad
Portugalska_nogometna_natjecanja,5,2,2,19,0,43,1,72,Bad
Povijest_neovisne_Bosne_i_Hercegovine,18,3,24,445,0,157,1,648,Bad
Nagrađeni_filmski_redatelji,0,2,2,74,0,41,1,120,Bad
Geografija_u_Hrvatskoj,7,1,2,53,0,68,1,132,Bad
Suvremene_bitke,5,4,8,228,0,45,3,293,Bad
Sjemenjače,3,2,504,3670,0,167,2,4348,Bad
Nedostaje_infookvir,363,1,1,1,0,175,0,541,Bad
Malajsko-polinezijski_narodi,7,7,11,62,0,32,4,123,Bad
Nagrađeni_znanstvenici,0,4,8,402,0,54,4,472,Bad
Povijest_1945.-1989.,13,4,56,1172,0,58,1,1304,Bad
Hrvatska_nogometna_natjecanja,4,12,211,453,0,104,2,786,Bad
Povijest_od_1989.,6,3,101,2385,0,50,1,2546,Bad
Nagrade_wikipedista,0,1,1,0,0,61,0,63,Bad
Etničke_grupe_Venezuele,5,1,1,77,0,63,2,149,Bad
Engleski_športaši,1,3,5,100,0,73,1,183,Bad
Hokej_na_ledu_u_Kazahstanu,2,1,1,25,0,45,1,75,Bad
Hokej_na_ledu_u_Latviji,2,1,1,23,0,36,0,63,Bad
Hokej_na_ledu_u_Švicarskoj,1,1,1,27,0,41,0,71,Bad
Prvoligaška_športska_natjecanja,5,2,27,259,0,29,2,324,Bad
Njemačka_nogometna_natjecanja,6,1,1,12,0,45,1,66,Bad
Sjevernoamerička_filozofija,0,1,1,36,0,59,1,98,Bad
Politika_Češke,1,1,1,17,0,62,1,83,Bad
Britanski_nogometni_treneri,0,2,2,25,0,53,2,84,Bad
Krški_reljefni_oblici,13,3,9,174,0,1365,2,1566,Bad
Enciklopedije,18,1,1,29,0,189,1,239,Bad
Putnički_promet,2,3,16,238,0,80,1,340,Bad
Teretni_promet,4,1,2,44,0,81,2,134,Bad
Dijalekti,0,1,3,30,0,7,7,48,Bad
Povijest_SAD-a_1865.-1914.,7,2,2,25,0,71,3,110,Bad
Obavještajci,8,1,1,28,0,90,1,129,Bad
Istočnosudanski_narodi,5,2,2,14,0,49,2,74,Bad
Pomoćni_predlošci,0,5,6,0,0,65,0,76,Bad
Neurotski_i_somatoformni_poremećaji,2,1,1,20,0,104,1,129,Bad
Portugalska_glazba,2,2,4,18,0,54,1,81,Bad
Nacionalna_športska_natjecanja_po_sezonama,0,8,8,143,0,43,4,206,Bad
Nogometni_kupovi_u_Hrvatskoj,30,4,4,38,0,75,1,152,Bad
Nagrađeni_televizijski_glumci,1,2,2,189,0,41,1,236,Bad
Canis,3,3,4,55,0,83,5,153,Bad
Nogomet_na_Hvaru,22,1,2,1,0,71,0,97,Bad
Treća_županijska_nogometna_liga,15,5,15,5,0,72,0,112,Bad
Etničke_grupe_Sibira,15,2,2,5,0,102,3,129,Bad
Srednjonjemački_jezici,15,1,1,7,0,58,2,84,Bad
Mezopotamski_vladari,3,2,2,26,0,83,1,117,Bad
Tenis_u_SAD–u,0,2,2,31,0,28,2,65,Bad
UNESCO,6,4,130,2091,0,46,1,2278,Bad
Snimke_ekrana,0,7,7,0,0,36,0,50,Bad
Europska_klupska_natjecanja,2,5,25,374,0,41,1,448,Bad
Izraelski_športski_klubovi,1,2,3,14,0,35,1,56,Bad
Hrvati_u_Austriji,46,4,6,191,0,242,1,490,Bad
Olimpijski_pobjednici_u_nordijskom_skijanju,0,3,3,32,0,38,1,77,Bad
Zdravstvena_zaštita,18,4,27,343,0,182,1,575,Bad
Povijest_SAD-a_do_1789.,7,2,4,23,0,80,3,119,Bad
Povijest_1945.-1989._po_državama,0,7,42,825,0,48,1,923,Bad
Laboratorijski_rad,3,3,4,62,0,64,1,137,Bad
Javno_dobro,0,3,16,0,0,66,0,85,Bad
Predlošci_sastava_nogometnih_reprezentacija,1,1,18,0,0,36,0,56,Bad
Boks_u_Hrvatskoj,5,1,1,33,0,161,1,202,Bad
Primarne_djelatnosti,6,4,35,532,0,320,5,902,Bad
Srpski_športski_klubovi,9,3,23,252,0,42,3,332,Bad
Nagrađeni_filmski_glumci,0,10,10,245,0,100,1,366,Bad
Hrvatska_u_prvoj_Jugoslaviji,34,5,14,559,0,187,1,800,Bad
Astronautika_u_SAD-u,39,2,3,72,0,85,1,202,Bad
Wikipedija,10,29,19442,192220,239,2758,7,214705,Good
Održavanje_Wikipedije,0,60,19442,192220,103,1994,7,213826,Good
Kategorije,0,11,19442,192220,108,585,7,212373,Good
Kategorizacija_Wikipedije,0,9,19442,192220,50,271,7,211999,Good
Znanost,65,33,17936,181151,239,870,7,200301,Good
Znanje,3,4,17939,181182,105,247,7,199487,Good
Prirodne_znanosti,32,13,16094,170117,150,721,7,187134,Good
Društvo,93,27,14628,152411,187,801,1,168148,Good
Društvene_znanosti,42,21,12485,148880,160,639,1,162228,Good
Pretrpane_kategorije,0,22,11353,129673,0,195,7,141250,Good
Politika,322,27,11044,122015,212,1161,1,134782,Good
Geografija,47,14,11185,122347,244,931,1,134769,Good
Geologija,73,22,10762,120982,165,455,3,132462,Good
Antropogeografija,21,9,10947,120959,87,334,1,132358,Good
Politička_geografija,18,6,10894,120736,102,330,1,132087,Good
Države_svijeta,3,18,10835,120059,222,938,1,132076,Good
Kontinenti,12,9,10610,119774,206,1443,3,132057,Good
Fizička_geografija,44,7,10742,120697,95,361,1,131947,Good
Geomorfologija,62,19,10723,120443,84,311,1,131643,Good
Kategorije_po_kontinentima,0,9,10564,119587,94,433,1,130688,Good
Zemljopis_po_kontinentima,0,9,10531,119451,98,166,1,130256,Good
Kategorije_po_državama,1,150,10403,116090,114,1132,1,127891,Good
Države_u_Europi,0,50,7462,84639,192,14579,3,106925,Good
Kultura,96,36,8187,86711,210,899,3,96142,Good
Humanističke_znanosti,7,4,8099,87497,103,257,7,95974,Good
Europa,44,10,7488,84693,257,438,1,92931,Good
Zemljopis_Europe,6,8,7474,84645,122,255,3,92513,Good
Biologija,93,32,8794,71966,220,962,1,82068,Good
Povijest,45,38,4737,68091,234,1354,1,74500,Good
Umjetnost,54,22,4410,61900,206,3014,2,69608,Good
Primijenjene_znanosti,39,22,4342,62429,117,690,4,67643,Good
Antropologija,74,6,6207,55439,148,494,3,62371,Good
Zemljopis_po_državama,0,156,2915,55225,127,381,1,58805,Good
Kategorije_u_koje_treba_svrstati_postojeće_članke,0,141,2400,54648,16,200,2,57407,Good
Razredbeni_sustavi,3,2,5994,50256,51,129,3,56438,Good
Živi_svijet,8,11,5930,49480,111,324,3,55867,Good
Sistematika,111,5,5935,49485,38,249,3,55826,Good
Eukarioti,5,4,5355,49387,94,114,3,54962,Good
Životinje,13,7,4682,44781,218,658,3,50362,Good
Zoologija,73,10,4695,44880,142,295,3,50098,Good
Opisthokonta,4,3,4712,44890,0,48,3,49660,Good
Unikonta,1,1,4713,44891,0,33,3,49642,Good
Pravi_mnogostaničari,3,2,4666,44646,21,92,3,49433,Good
Bilateralne_životinje,5,3,4660,44616,21,103,3,49411,Good
Mnogostaničari,2,2,4668,44654,4,50,3,49383,Good
Kralježnjaci,11,7,4512,44088,109,297,3,49027,Good
Svitkovci,10,4,4517,44101,102,244,3,48981,Good
Mjeseci_u_godini,12,0,0,12,180,47375,20,47599,Good
Sisavci,17,6,4158,42275,173,544,3,47176,Good
Viši_sisavci,24,11,4152,42236,28,183,3,46637,Good
Čovjek,21,4,4048,41517,133,373,3,46099,Good
Primati,6,2,4066,41651,103,206,3,46037,Good
Haplorrhini,4,5,4064,41640,23,86,3,45825,Good
Hrvatska,39,29,2529,39161,175,3864,3,45800,Good
Čovjekoliki_majmuni,23,2,4051,41566,29,122,3,45796,Good
Homo,24,1,4049,41535,29,87,3,45728,Good
Administrativne_podjele,7,4,1806,43083,75,263,1,45239,Good
Podnacionalni_entiteti,50,78,1759,41035,59,222,1,43204,Good
Naselja,17,6,1545,41244,106,203,3,43124,Good
Životopisi_po_državama,0,145,2631,37156,102,221,3,40258,Good
Likovna_umjetnost,88,19,2343,36451,103,336,2,39342,Good
Fizika,92,23,1099,36231,201,764,7,38417,Good
Filozofija,106,17,1076,34825,199,852,7,37082,Good
Povijesna_znanost,36,9,1079,34759,5,223,4,36115,Good
Filozofske_discipline,2,11,1025,34209,78,277,7,35609,Good
Fizikalne_veličine,89,2,977,33741,100,522,7,35438,Good
Filozofska_terminologija,43,6,984,33834,55,316,7,35245,Good
Vrijeme,9,4,975,33718,178,351,7,35242,Good
Metafizički_pojmovi,30,1,976,33723,50,376,7,35163,Good
Metafizika,13,1,977,33751,88,174,7,35011,Good
Arhitektura,70,12,1990,32199,169,555,2,34997,Good
Kronologija,3,5,972,33628,118,217,2,34945,Good
Politika_po_državama,1,45,1418,30197,112,204,1,31978,Good
Organizacije,36,11,1354,27526,132,293,1,29353,Good
Gradovi_po_državama,1,129,1185,25686,103,1894,2,29000,Good
Gradovi,12,8,1303,26627,184,460,2,28596,Good
Urbanizam,34,4,1320,26789,71,236,3,28457,Good
Urbana_geografija,17,4,1321,26816,56,231,2,28447,Good
Povijest_po_državama,11,101,1867,25692,122,371,1,28165,Good
Povijest_kontinenata,0,6,1862,25688,83,315,1,27955,Good
Kategorije_po_razdobljima,0,17,501,26227,60,103,2,26910,Good
Država,55,6,1181,24970,68,445,1,26726,Good
Igre,44,10,3206,22370,131,489,7,26257,Good
Šport,53,24,3139,21884,208,678,7,25993,Good
Županije,1,4,978,24419,48,97,1,25548,Good
Povijest_Europe,5,42,1623,23180,134,384,1,25369,Good
Umjetnost_po_državama,3,39,1398,23519,83,168,1,25211,Good
Športovi,32,56,2555,20676,93,1588,7,25007,Good
Javna_uprava,11,6,1032,23518,64,267,1,24899,Good
Etnologija,31,10,2454,21852,95,210,2,24654,Good
Etnografija,25,7,2443,21766,84,186,2,24513,Good
Državne_institucije,39,12,979,22670,65,609,1,24375,Good
Kalendar,57,15,482,22631,161,602,38,23986,Good
Zemljopis_Hrvatske,68,30,903,22300,84,548,1,23934,Good
Stranice_s_čarobnim_ISBN_poveznicama,10775,0,0,10775,122,2225,1,23898,Good
Države_u_Aziji,0,50,1454,12591,183,9316,2,23596,Good
Stoljeća,144,73,353,21524,147,435,38,22714,Good
Politika_Hrvatske,57,11,863,20866,56,338,1,22192,Good
Sjeverna_Amerika,17,5,1032,20232,182,559,2,22029,Good
